14 14 14 14 14 14 14 14 14 14 14 14 14 14 14 14 14 14 14 14 14 14 14 14 14 14 14 14 14 14 14 14 14 14 14 14 14 14 14 14 14 14 14 14 14 14 14 14 14 14 14 14 14 14 14 14 14 14 14 14
14 14 14 14 14 14 14 14 14 14 14 14 14 14 14 14 14 14 14 14 14 14 14 14 14 14 14 14 14 14 14 14 14 14 14 14 14 14 14 14 14 14 14 14 14 14 14 14 14 14 14 14 14 14 14 14 14 14 14 14
14 14 14 14 14 14 14 14 14 14 14 14 14 14 14 14 14 14 14 14 14 14 14 14 14 14 14 14 14 14 14 14 14 14 14 14 14 14 14 14 14 14 14 14 14 14 14 14 14 14 14 14 14 14 14 14 14 14 14 14
14 14 14 14 14 14 14 14 14 14 14 14 14 14 14 14 14 14 14 14 14 14 14 14 14 14 14 14 14 14 14 14 14 14 14 14 14 14 14 14 14 14 14 14 14 14 14 14 14 14 14 14 14 14 14 14 14 14 14 14
14 14 14 14 14 14 14 14 14 14 14 14 14 14 14 14 14 14 14 14 14 14 14 14 14 14 14 14 14 14 14 14 14 14 14 14 14 14 14 14 14 14 14 14 14 14 14 14 14 14 14 14 14 14 14 14 14 14 14 14
14 14 14 14 14 14 14 14 14 14 14 14 14 14 14 14 14 14 14 14 14 14 14 10 35 10 10 10 10 10 14 14 14 14 14 14 14 14 14 14 14 14 14 14 14 14 14 14 14 14 14 14 14 14 14 14 14 14 14 14
14 14 14 14 14 14 14 14 14 14 14 14 14 14 14 14 14 14 14 14 14 14 10 10 10 10 10 10 10 35 10 14 14 14 14 14 14 14 14 14 14 14 14 14 14 14 14 14 14 14 14 14 14 14 14 14 14 14 14 14
14 14 14 14 14 14 14 14 14 14 14 14 14 14 14 14 14 14 14 14 14 10 10 10 10 35 10 10 10 10 10 14 14 14 14 14 14 14 14 14 14 14 14 14 14 14 14 14 14 14 14 14 14 14 14 14 14 14 14 14
14 14 14 14 14 14 14 14 14 10 10 10 10 10 14 14 14 14 14 14 14 10 10 35 10 10 35 10 10 10 10 14 14 10 10 10 10 10 14 14 14 14 14 14 14 14 14 14 14 14 14 14 14 14 14 14 14 14 14 14
14 14 14 14 14 14 14 14 14 10 14 34 34 10 34 34 14 14 14 14 14 10 10 10 10 10 10 10 10 10 10 10 10 10 10 10 10 10 14 14 14 14 14 14 14 14 14 14 14 14 14 14 14 14 14 14 14 14 14 14
14 14 14 14 14 14 14 14 14 10 14 34 13 13 13 34 14 14 14 14 14 10 10 35 10 10 35 10 10 35 10 10 10 10 10 14 10 10 43 38 38 38 38 38 38 44 14 14 14 14 14 14 14 14 14 14 14 14 14 14
14 14 14 14 14 14 14 14 14 10 14 34 13 13 13 34 14 14 14 14 14 14 10 10 10 10 10 10 10 10 10 10 10 14 14 14 10 10 36 15 15 15 15 15 15 37 14 14 14 14 14 14 14 14 14 14 14 14 14 14
14 14 14 14 14 14 14 14 14 10 14 34 13 13 13 34 14 14 14 14 14 14 14 10 10 43 38 44 14 14 53 47 47 47 47 47 54 10 36 15 15 15 15 15 15 37 14 14 14 14 14 14 14 14 14 14 14 14 14 14
14 14 14 14 14 14 14 14 14 10 14 34 13 13 13 34 14 14 14 14 14 14 14 10 10 36 15 37 14 14 51 12 12 12 12 12 52 10 36 15 15 15 15 15 15 37 14 14 14 14 14 14 14 14 14 14 14 14 14 14
14 14 14 14 14 14 14 14 14 10 14 34 34 35 34 34 14 14 14 14 14 14 14 10 10 36 15 40 38 44 51 12 12 12 12 12 52 10 36 15 15 15 15 15 15 37 14 14 14 14 14 14 14 14 14 14 14 14 14 14
14 14 14 14 14 14 14 14 14 10 14 14 14 10 14 14 14 14 14 14 14 14 14 10 10 36 15 15 15 56 58 58 58 58 58 58 58 57 36 15 15 15 15 15 55 42 14 14 14 14 14 14 14 14 14 14 14 14 14 14
14 14 14 14 14 14 14 14 14 10 14 14 14 10 14 14 14 14 14 14 14 14 14 14 10 36 15 55 39 42 51 12 12 12 12 12 52 10 41 39 59 15 55 39 42 14 14 14 14 14 14 14 14 14 14 14 14 14 14 14
14 14 14 14 14 14 14 14 14 10 14 14 14 35 14 14 14 14 14 14 14 14 14 14 10 36 15 37 14 10 51 12 12 12 12 12 52 10 14 14 36 15 37 14 14 14 14 14 14 14 14 14 14 14 14 14 14 14 14 14
14 14 14 14 14 14 14 14 10 10 14 14 14 10 14 14 14 14 14 14 14 14 14 14 10 36 15 37 14 10 49 48 48 48 48 48 50 10 14 43 60 15 37 14 14 14 14 14 14 14 14 14 14 14 14 14 14 14 14 14
14 14 14 14 14 14 14 14 10 14 14 10 10 35 14 14 14 14 14 14 14 14 14 14 10 36 15 37 14 10 10 10 10 10 10 10 10 10 14 36 15 15 37 14 14 14 14 14 14 14 14 14 14 14 14 14 14 14 14 14
14 14 14 14 14 14 14 14 10 14 14 35 14 14 14 14 14 14 14 14 14 14 14 14 10 41 39 42 14 10 10 10 10 10 10 10 10 14 43 60 15 55 42 14 14 14 14 14 14 14 14 14 14 14 14 14 14 14 14 14
14 14 14 14 14 14 14 14 10 14 14 10 14 14 14 14 14 14 14 14 14 14 14 14 10 10 10 10 14 14 14 14 14 14 14 14 14 14 36 15 15 37 14 14 14 14 14 14 14 14 14 14 14 14 14 14 14 14 14 14
14 14 14 14 14 14 14 14 10 14 14 10 14 14 14 14 14 14 14 14 14 14 14 14 10 35 10 10 10 14 14 14 14 14 14 14 14 43 60 15 55 42 14 14 14 14 14 14 14 14 14 14 14 14 14 14 14 14 14 14
14 14 14 14 14 14 14 14 10 14 14 10 14 14 14 14 14 14 14 14 14 14 14 10 10 10 10 10 10 10 10 43 38 38 38 38 38 60 15 15 37 14 14 14 14 14 14 14 14 14 14 14 14 14 14 14 14 14 14 14
14 14 14 14 14 14 14 14 10 14 14 10 14 14 14 14 14 14 14 14 14 14 14 10 10 10 35 10 35 10 10 36 15 15 15 15 15 15 15 15 37 14 14 14 14 14 14 14 14 14 14 14 14 14 14 14 14 14 14 14
14 14 14 14 14 14 14 14 10 14 14 35 14 14 14 14 14 14 14 14 14 14 14 10 10 10 10 10 10 10 14 41 39 39 39 39 39 39 59 15 37 14 14 14 14 14 14 14 14 14 14 14 14 14 14 14 14 14 14 14
14 14 14 14 14 14 14 14 10 14 14 10 14 14 14 35 14 14 14 14 14 14 14 10 10 10 10 10 10 10 10 10 14 14 14 14 14 14 36 15 37 14 14 14 14 14 14 14 14 14 14 14 14 14 14 14 14 14 14 14
14 14 14 14 14 14 14 14 10 14 14 10 14 14 14 10 14 14 14 14 14 14 14 10 10 43 38 44 10 10 35 10 14 14 14 14 14 14 36 15 37 14 14 14 14 14 14 14 14 14 14 14 14 14 14 14 14 14 14 14
14 14 14 14 14 14 14 14 10 14 14 35 14 14 14 10 10 10 14 14 14 14 14 14 14 36 15 37 14 14 14 14 14 14 14 14 14 14 36 15 37 14 14 14 14 14 14 14 14 14 14 14 14 14 14 14 14 14 14 14
14 14 14 14 14 14 14 14 10 14 14 10 14 14 14 14 14 35 14 14 14 14 14 14 14 36 15 37 14 14 14 14 14 14 14 14 14 14 36 15 37 14 14 14 14 14 14 14 14 14 14 14 14 14 14 14 14 14 14 14
14 14 14 14 14 14 14 14 10 14 14 35 14 14 14 14 14 10 14 14 35 10 14 14 14 36 15 37 14 14 10 14 14 14 14 14 14 14 36 15 37 14 14 14 14 14 14 14 14 14 14 14 14 14 14 14 14 14 14 14
14 14 14 14 14 14 14 14 10 14 14 10 14 14 14 14 14 10 14 10 10 14 14 14 14 36 15 37 14 14 14 14 14 10 14 14 14 14 36 15 37 14 14 14 14 14 14 14 14 14 14 14 14 14 14 14 14 14 14 14
14 14 14 14 14 14 14 14 10 14 14 10 10 10 35 10 10 35 14 10 14 14 14 14 14 36 15 37 14 14 14 14 14 10 14 14 14 14 36 15 37 14 14 14 14 14 14 14 14 14 14 14 14 14 14 14 14 14 14 14
14 14 14 14 14 14 14 14 10 14 14 35 10 10 10 10 10 10 10 10 14 14 14 14 14 36 15 37 14 14 14 14 14 14 14 14 14 14 41 39 42 14 14 14 14 14 14 14 14 14 14 14 14 14 14 14 14 14 14 14
14 14 14 14 14 14 14 14 10 14 14 10 10 10 10 10 10 10 10 10 14 14 14 14 14 36 15 37 14 14 14 14 14 14 14 14 14 14 10 35 10 14 14 14 14 14 14 14 14 14 14 14 14 14 14 14 14 14 14 14
14 14 14 14 14 14 14 14 10 14 14 10 10 10 35 10 10 35 10 10 10 14 14 14 14 36 15 37 14 14 14 14 14 14 14 14 14 14 10 10 10 14 14 14 14 14 14 14 14 14 14 14 14 14 14 14 14 14 14 14
14 14 14 14 14 14 14 14 10 14 14 10 35 10 10 10 10 10 10 35 10 14 14 14 14 36 15 37 14 14 14 14 14 14 14 14 14 14 10 10 10 14 14 14 14 14 14 14 14 14 14 14 14 14 14 14 14 14 14 14
14 14 14 14 14 14 14 14 10 14 14 10 10 10 35 10 10 10 14 14 10 14 14 14 14 36 15 37 14 14 14 14 14 14 14 14 14 14 35 10 10 14 14 14 14 14 14 14 14 14 14 14 14 14 14 14 14 14 14 14
14 14 14 14 14 14 14 14 10 14 14 14 14 14 14 14 14 14 14 14 10 14 14 14 14 36 15 37 14 14 14 14 14 14 14 14 14 14 10 10 35 14 14 14 14 14 14 10 10 10 14 14 14 14 14 14 14 14 14 14
14 14 14 14 14 14 14 14 10 14 14 14 14 14 14 14 14 14 14 14 35 10 10 35 10 41 39 42 10 10 14 14 14 14 14 14 14 10 10 10 10 10 35 10 10 10 10 35 35 10 46 14 14 14 14 14 14 14 14 14
14 14 14 14 14 14 14 14 10 14 14 14 14 14 14 14 14 14 14 14 10 10 10 10 10 10 10 10 10 35 10 14 14 10 14 14 35 10 10 10 10 10 10 10 10 10 10 10 10 35 10 14 14 14 14 14 14 14 14 14
14 14 14 14 14 14 14 14 10 14 14 14 14 14 14 14 14 14 14 14 10 10 35 10 10 10 10 10 10 10 10 14 14 14 14 10 10 10 10 10 10 10 14 14 14 14 14 10 10 10 10 14 14 14 14 14 14 14 14 14
14 14 14 14 14 14 14 14 10 14 14 14 14 14 14 14 10 14 14 14 14 10 10 10 10 10 10 10 10 10 10 10 10 10 10 10 10 10 10 35 14 10 14 14 14 14 14 14 10 10 10 14 14 14 14 14 14 14 14 14
14 14 14 14 14 14 14 14 10 14 14 14 14 14 14 14 14 14 14 14 14 10 35 10 10 10 10 35 10 10 10 35 10 10 10 35 10 14 10 10 10 10 14 14 14 14 14 14 10 10 10 14 14 14 14 14 14 14 14 14
14 14 14 14 14 14 14 14 10 14 14 14 14 14 14 14 10 14 14 14 14 14 10 10 10 10 35 10 10 10 10 10 10 10 10 10 10 10 10 10 10 10 14 14 14 14 14 14 14 35 10 14 14 14 14 14 14 14 14 14
14 14 14 14 14 14 14 14 10 14 14 14 10 10 10 10 10 14 14 14 14 14 14 10 10 10 10 10 10 10 10 10 10 10 10 10 10 10 35 14 10 35 10 10 10 10 10 10 10 10 10 10 14 14 14 14 14 14 14 14
14 14 14 14 14 14 14 14 10 14 14 10 10 10 10 10 10 10 14 14 14 14 14 14 10 10 10 10 10 10 10 10 10 10 10 35 10 10 10 10 10 10 10 10 10 10 10 10 10 10 10 14 14 14 14 14 14 14 14 14
14 14 14 14 14 14 14 14 10 14 14 10 35 10 10 10 10 10 14 14 14 14 14 14 10 10 10 10 10 10 10 10 10 10 10 10 10 10 10 10 10 10 10 10 10 10 10 10 10 10 10 35 14 14 14 14 14 14 14 14
14 14 14 14 14 14 14 14 10 10 10 10 10 10 10 35 10 10 14 14 14 14 14 14 10 10 10 10 10 10 10 10 10 10 10 10 10 10 10 10 10 10 10 10 10 10 10 10 10 10 10 10 14 14 14 14 14 14 14 14
14 14 14 14 14 14 14 14 15 14 14 10 10 10 10 10 10 10 14 14 14 14 14 14 10 10 35 10 10 10 10 10 10 10 10 10 10 10 10 10 10 10 35 10 10 10 10 10 35 10 10 10 14 14 14 14 14 14 14 14
14 14 14 14 14 14 14 14 15 14 14 10 10 10 10 10 10 10 10 10 10 10 10 35 10 10 35 10 10 10 10 10 10 10 10 10 10 10 10 10 10 10 10 10 10 10 10 10 10 10 10 10 10 14 14 14 14 14 14 14
14 14 14 14 14 14 14 14 15 14 14 14 10 10 35 10 10 35 10 10 10 10 10 10 10 10 10 10 10 10 10 10 10 10 10 10 10 10 10 10 10 10 10 10 10 10 10 10 10 10 10 10 10 10 14 14 14 14 14 14
14 14 14 14 14 14 14 14 15 14 14 14 14 14 10 10 10 10 10 10 10 10 10 10 10 10 10 10 10 10 10 10 10 10 10 10 10 10 10 10 10 10 10 10 10 35 10 10 10 10 10 10 10 10 14 14 14 14 14 14
14 14 14 14 14 14 14 14 15 14 14 14 14 14 14 10 10 10 10 10 10 35 10 10 35 10 14 14 14 14 14 10 10 10 10 10 10 10 10 10 10 10 10 10 10 10 10 10 10 10 10 10 10 10 10 14 14 14 14 14
14 14 14 14 14 14 14 14 15 14 14 14 14 14 14 14 14 14 10 10 10 10 10 10 10 10 14 14 14 14 14 14 10 10 10 10 25 11 11 11 11 11 11 11 11 11 11 11 11 11 26 10 10 10 10 14 14 14 14 14
14 14 14 14 14 14 14 14 15 15 15 14 14 14 14 14 14 14 35 10 10 10 10 10 10 35 14 14 14 14 14 14 10 10 10 10 21 13 77 79 79 78 13 13 17 17 13 13 13 13 21 10 10 10 10 14 14 14 14 14
14 14 14 14 14 14 14 14 14 14 15 14 14 10 10 10 10 10 10 10 10 35 10 10 10 10 14 14 14 14 14 10 10 10 10 10 21 45 45 45 45 45 45 45 17 17 45 45 45 45 21 10 10 10 14 14 14 14 14 14
14 14 14 14 14 14 14 14 14 14 15 14 14 10 10 10 10 10 10 10 10 10 35 10 10 10 14 14 14 14 14 10 10 10 10 10 21 17 17 17 17 17 17 17 17 17 17 17 17 17 21 10 10 10 14 14 14 14 14 14
14 14 14 14 14 14 14 14 14 14 14 14 10 10 35 10 10 10 10 35 10 10 10 10 10 10 14 14 14 14 14 35 10 10 10 10 21 17 17 17 17 17 17 17 17 80 81 17 17 17 21 10 10 35 14 14 14 14 14 14
14 14 14 14 14 14 14 14 14 14 14 10 10 10 10 53 47 47 47 47 47 47 47 47 54 10 14 14 14 14 14 10 10 10 10 10 21 17 17 17 17 17 17 17 17 82 83 17 17 17 21 10 10 10 14 14 14 14 14 14
14 14 14 14 14 14 14 14 10 10 10 10 10 10 10 51 12 74 12 12 12 12 12 12 52 10 14 14 14 14 14 10 10 10 10 10 21 17 17 17 17 17 17 17 17 84 85 17 17 17 21 10 10 10 14 14 14 14 14 14
14 14 14 14 14 14 14 14 10 10 10 35 10 53 47 63 12 12 12 12 12 12 12 12 64 67 14 14 14 14 14 10 10 10 10 10 21 17 17 17 17 17 17 17 17 17 17 17 17 17 21 10 10 10 14 14 14 14 14 14
14 14 14 14 14 14 14 14 10 53 47 47 47 63 12 12 12 12 12 12 12 74 12 12 12 62 14 14 14 14 14 10 10 35 10 10 21 17 17 17 17 17 17 17 17 17 17 17 17 17 21 10 10 10 14 14 14 14 14 14
14 14 14 14 14 14 14 14 35 51 12 12 12 12 12 12 12 12 12 12 12 12 12 12 12 62 14 14 14 14 14 10 10 10 10 10 21 17 17 17 17 17 17 17 17 17 17 17 17 17 21 10 10 10 14 14 14 14 14 14
14 14 14 14 14 14 14 14 10 51 12 12 74 12 12 12 12 75 75 75 75 12 12 12 12 62 14 14 14 14 14 10 10 10 10 10 21 17 17 17 17 17 17 17 17 17 17 17 17 17 21 10 10 10 14 14 14 14 14 14
14 14 14 14 14 14 14 14 10 51 12 12 12 12 12 12 12 75 75 75 75 12 12 74 12 62 14 14 14 14 14 10 10 10 10 10 23 11 11 11 11 11 11 11 11 11 11 11 11 11 24 10 10 10 14 14 14 14 14 14
14 14 14 14 14 14 14 14 10 51 74 12 12 12 12 12 12 75 75 75 75 58 58 58 58 57 14 14 14 14 14 14 10 10 10 10 10 10 10 10 10 10 10 10 10 10 10 35 10 10 10 10 10 10 14 14 14 14 14 14
14 14 14 14 14 14 14 14 35 51 12 12 12 12 74 12 12 75 75 75 75 12 12 12 12 62 14 14 14 14 14 14 10 10 10 10 10 10 35 10 10 10 10 10 10 10 10 10 10 10 10 10 10 10 14 14 14 14 14 14
14 14 14 14 14 14 14 14 10 51 12 12 12 12 12 12 12 58 58 58 58 12 12 12 66 73 14 14 14 14 14 14 14 10 10 10 10 10 10 10 10 10 10 10 10 10 10 10 35 10 10 10 10 14 14 14 14 14 14 14
14 14 14 14 14 14 14 14 10 49 48 48 65 12 12 12 12 12 12 12 74 12 12 12 52 10 14 14 14 14 14 14 14 14 14 14 14 14 14 14 14 14 14 14 14 14 14 14 14 14 14 14 14 14 14 14 14 14 14 14
14 14 14 14 14 14 14 14 10 10 10 10 51 12 74 12 12 12 74 12 12 12 12 66 50 10 14 14 14 14 14 14 14 14 14 14 14 14 14 14 14 14 14 14 14 14 14 14 14 14 14 14 14 14 14 14 14 14 14 14
14 14 14 14 14 14 14 14 10 35 10 10 49 48 65 12 12 12 12 12 12 12 66 50 10 10 14 14 14 14 14 14 14 14 14 14 14 14 14 14 14 14 14 14 14 14 14 14 14 14 14 14 14 14 14 14 14 14 14 14
14 14 14 14 14 14 14 14 10 10 10 10 10 10 49 48 48 48 48 48 48 48 50 10 10 10 14 14 14 14 14 14 14 14 14 14 14 14 14 14 14 14 14 14 14 14 14 14 14 14 14 14 14 14 14 14 14 14 14 14
14 14 14 14 14 14 14 14 14 10 10 10 10 10 10 10 10 10 35 10 10 10 10 10 10 35 14 14 14 14 14 14 14 14 14 14 14 14 14 14 14 14 14 14 14 14 14 14 14 14 14 14 14 14 14 14 14 14 14 14
14 14 14 14 14 14 14 14 14 10 10 10 35 10 10 10 10 10 10 10 10 10 10 10 10 10 14 14 14 14 14 14 14 14 14 14 14 14 14 14 14 14 14 14 14 14 14 14 14 14 14 14 14 14 14 14 14 14 14 14
14 14 14 14 14 14 14 14 14 10 10 10 10 10 10 10 10 10 10 10 10 10 10 10 10 10 10 10 14 14 14 14 14 14 14 14 14 14 14 14 14 14 14 14 14 14 14 14 14 14 14 14 14 14 14 14 14 14 14 14
14 14 14 14 14 14 14 14 14 10 10 10 10 10 10 10 10 10 10 10 10 10 10 10 10 10 10 10 14 14 14 14 14 14 14 14 14 14 14 14 14 14 14 14 14 14 14 14 14 14 14 14 14 14 14 14 14 14 14 14
14 14 14 14 14 14 14 14 14 10 10 10 10 35 10 10 10 10 14 14 14 14 14 14 14 10 10 10 14 14 14 14 14 14 14 14 14 14 14 14 14 14 14 14 14 14 14 14 14 14 14 14 14 14 14 14 14 14 14 14
14 14 14 14 14 14 14 14 14 14 14 10 10 10 10 10 10 14 14 14 14 14 14 14 14 14 14 14 14 14 14 14 14 14 14 14 14 14 14 14 14 14 14 14 14 14 14 14 14 14 14 14 14 14 14 14 14 14 14 14
14 14 14 14 14 14 14 14 14 14 14 14 10 10 10 10 14 14 14 14 14 14 14 14 14 14 14 14 14 14 14 14 14 14 14 14 14 14 14 14 14 14 14 14 14 14 14 14 14 14 14 14 14 14 14 14 14 14 14 14
14 14 14 14 14 14 14 14 14 14 14 14 14 14 14 14 14 14 14 14 14 14 14 14 14 14 14 14 14 14 14 14 14 14 14 14 14 14 14 14 14 14 14 14 14 14 14 14 14 14 14 14 14 14 14 14 14 14 14 14
14 14 14 14 14 14 14 14 14 14 14 14 14 14 14 14 14 14 14 14 14 14 14 14 14 14 14 14 14 14 14 14 14 14 14 14 14 14 14 14 14 14 14 14 14 14 14 14 14 14 14 14 14 14 14 14 14 14 14 14
14 14 14 14 14 14 14 14 14 14 14 14 14 14 14 14 14 14 14 14 14 14 14 14 14 14 14 14 14 14 14 14 14 14 14 14 14 14 14 14 14 14 14 14 14 14 14 14 14 14 14 14 14 14 14 14 14 14 14 14
14 14 14 14 14 14 14 14 14 14 14 14 14 14 14 14 14 14 14 14 14 14 14 14 14 14 14 14 14 14 14 14 14 14 14 14 14 14 14 14 14 14 14 14 14 14 14 14 14 14 14 14 14 14 14 14 14 14 14 14
14 14 14 14 14 14 14 14 14 14 14 14 14 14 14 14 14 14 14 14 14 14 14 14 14 14 14 14 14 14 14 14 14 14 14 14 14 14 14 14 14 14 14 14 14 14 14 14 14 14 14 14 14 14 14 14 14 14 14 14
14 14 14 14 14 14 14 14 14 14 14 14 14 14 14 14 14 14 14 14 14 14 14 14 14 14 14 14 14 14 14 14 14 14 14 14 14 14 14 14 14 14 14 14 14 14 14 14 14 14 14 14 14 14 14 14 14 14 14 14


