14 14 14 14 14 14 14 14 14 14 14 14 14 14 14 14 14 14 14 14 14 14 14 14 14 14 14 14 14 14 14 14 14 14 14 14 14 14 14 14 14 14 14 14 14 14 14 14 14 14 14 14 14 14 14 14 14 14 14 14
14 14 14 14 14 14 14 14 14 14 14 14 14 14 14 14 14 14 14 14 14 14 14 14 14 14 14 14 14 14 14 14 14 14 14 14 14 14 14 14 14 14 14 14 14 14 14 14 14 14 14 14 14 14 14 14 14 14 14 14
14 14 14 14 14 14 14 14 14 14 14 14 14 14 14 14 14 14 14 14 14 14 14 14 14 14 14 14 14 14 14 14 14 14 14 14 14 14 14 14 14 14 14 14 14 14 14 14 14 14 14 14 14 14 14 14 14 14 14 14
14 14 14 14 14 14 14 14 14 14 14 14 14 14 14 14 14 14 14 14 14 14 14 14 14 14 14 14 14 14 14 14 14 14 14 14 14 14 14 14 14 14 14 14 14 14 14 14 14 14 14 14 14 14 14 14 14 14 14 14
14 14 14 14 14 14 14 14 14 14 14 14 14 14 14 14 14 14 14 14 14 14 14 14 14 14 14 14 14 14 14 14 14 14 14 14 14 14 14 14 14 14 14 14 14 14 14 14 14 14 14 14 14 14 14 14 14 14 14 14
14 14 14 14 14 14 14 14 14 14 14 14 14 14 14 14 14 14 14 14 14 14 14 10 35 10 10 10 10 10 14 14 14 14 14 14 14 14 14 14 14 14 14 14 14 14 14 14 14 14 14 14 14 14 14 14 14 14 14 14
14 14 14 14 14 14 14 14 14 14 14 14 14 14 14 14 14 14 14 14 14 14 10 10 10 10 10 10 10 35 10 14 14 14 14 14 14 14 14 14 14 14 14 14 14 14 14 14 14 14 14 14 14 14 14 14 14 14 14 14
14 14 14 14 14 14 14 14 14 14 14 14 14 14 14 14 14 14 14 14 14 14 10 10 10 35 10 10 10 10 10 14 14 14 14 14 14 14 14 14 14 14 14 14 14 14 14 14 14 14 14 14 14 14 14 14 14 14 14 14
14 14 14 14 14 14 14 14 14 10 10 10 10 10 14 14 14 14 14 14 14 14 10 35 10 10 35 10 10 10 10 14 14 14 10 10 10 10 14 14 14 14 14 14 14 14 14 14 14 14 14 14 14 14 14 14 14 14 14 14
14 14 14 14 14 14 14 14 14 10 14 34 34 10 34 34 14 14 14 14 14 14 10 10 10 10 10 10 10 14 10 14 14 10 10 10 10 10 14 14 14 14 14 14 14 14 14 14 14 14 14 14 14 14 14 14 14 14 14 14
14 14 14 14 14 14 14 14 14 10 14 34 13 13 13 34 14 14 14 14 14 14 14 35 10 10 35 10 10 35 10 10 10 10 10 14 10 10 43 38 38 38 38 38 38 44 14 14 14 14 14 14 14 14 14 14 14 14 14 14
14 14 14 14 14 14 14 14 14 10 14 34 13 13 13 34 14 14 14 14 14 14 14 14 10 10 10 10 10 10 10 10 10 14 14 14 10 10 36 15 15 15 15 15 15 37 14 14 14 14 14 14 14 14 14 14 14 14 14 14
14 14 14 14 14 14 14 14 14 10 14 34 13 13 13 34 14 14 14 14 14 14 14 14 14 43 38 44 14 14 53 47 47 47 47 47 54 10 36 15 15 15 15 15 15 37 14 14 14 14 14 14 14 14 14 14 14 14 14 14
14 14 14 14 14 14 14 14 14 10 14 34 13 13 13 34 14 14 14 14 14 14 14 14 14 36 15 37 14 14 51 12 12 12 12 12 52 10 36 15 15 15 15 15 15 37 14 14 14 14 14 14 14 14 14 14 14 14 14 14
14 14 14 14 14 14 14 14 14 10 14 34 34 35 34 34 14 14 14 14 14 14 14 14 14 36 15 40 38 44 51 12 12 12 12 12 52 10 36 15 15 15 15 15 15 37 14 14 14 14 14 14 14 14 14 14 14 14 14 14
14 14 14 14 14 14 14 14 14 10 14 14 14 10 14 14 14 14 14 14 14 14 14 14 14 36 15 15 15 56 58 58 58 58 58 58 58 57 36 15 15 15 15 15 55 42 14 14 14 14 14 14 14 14 14 14 14 14 14 14
14 14 14 14 14 14 14 14 14 10 14 14 14 10 14 14 14 14 14 14 14 14 14 14 14 36 15 55 39 42 51 12 12 12 12 12 52 10 41 39 59 15 55 39 42 14 14 14 14 14 14 14 14 14 14 14 14 14 14 14
14 14 14 14 14 14 14 14 14 10 14 14 14 35 14 14 14 14 14 14 14 14 14 14 14 36 15 37 14 10 51 12 12 12 12 12 52 10 14 14 36 15 37 14 14 14 14 14 14 14 14 14 14 14 14 14 14 14 14 14
14 14 14 14 14 14 14 14 10 10 14 14 14 10 14 14 14 14 14 14 14 14 14 14 14 36 15 37 14 10 49 48 48 48 48 48 50 10 14 43 60 15 37 14 14 14 14 14 14 14 14 14 14 14 14 14 14 14 14 14
14 14 14 14 14 14 14 14 10 14 14 10 10 35 14 14 14 14 14 14 14 14 14 14 14 36 15 37 14 10 10 10 10 10 10 10 10 10 14 36 15 15 37 14 14 14 14 14 14 14 14 14 14 14 14 14 14 14 14 14
14 14 14 14 14 14 14 14 10 14 14 35 14 14 14 14 14 14 14 14 14 14 14 14 14 41 39 42 14 10 10 10 10 10 10 10 10 14 43 60 15 55 42 14 14 14 14 14 14 14 14 14 14 14 14 14 14 14 14 14
14 14 14 14 14 14 14 14 10 14 14 10 14 14 14 14 14 14 14 14 14 14 14 14 10 10 10 10 14 14 14 14 14 14 14 14 14 14 36 15 15 37 14 14 14 14 14 14 14 14 14 14 14 14 14 14 14 14 14 14
14 14 14 14 14 14 14 14 10 14 14 35 14 14 14 14 14 14 14 14 14 14 14 14 10 35 10 14 14 14 14 14 14 14 14 14 14 43 60 15 55 42 14 14 14 14 14 14 14 14 14 14 14 14 14 14 14 14 14 14
14 14 14 14 14 14 14 14 10 14 14 10 14 14 14 14 14 14 14 14 14 14 14 10 10 10 10 10 10 10 10 43 38 38 38 38 38 60 15 15 37 14 14 14 14 14 14 14 14 14 14 14 14 14 14 14 14 14 14 14
14 14 14 14 14 14 14 14 10 14 14 10 14 14 14 14 14 14 14 14 14 14 14 10 10 10 35 10 35 10 10 36 15 15 15 15 15 15 15 15 37 14 14 14 14 14 14 14 14 14 14 14 14 14 14 14 14 14 14 14
14 14 14 14 14 14 14 14 10 14 14 35 14 14 14 14 14 14 14 14 14 14 14 14 10 10 10 10 10 10 14 41 39 39 39 39 39 39 59 15 37 14 14 14 14 14 14 14 14 14 14 14 14 14 14 14 14 14 14 14
14 14 14 14 14 14 14 14 10 14 14 10 14 14 14 35 14 14 14 14 14 14 35 14 14 10 10 10 10 10 10 10 14 14 14 14 14 14 36 15 37 14 14 14 14 14 14 14 14 14 14 14 14 14 14 14 14 14 14 14
14 14 14 14 14 14 14 14 10 14 14 10 14 14 14 10 14 14 14 14 14 14 14 10 10 43 38 44 10 10 35 10 14 14 14 14 14 14 36 15 37 14 14 14 14 14 14 14 14 14 14 14 14 14 14 14 14 14 14 14
14 14 14 14 14 14 14 14 10 14 14 35 14 14 14 10 35 10 14 14 14 14 14 14 14 36 15 37 14 14 14 14 14 14 14 14 14 14 36 15 37 14 14 14 14 14 14 14 14 14 14 14 14 14 14 14 14 14 14 14
14 14 14 14 14 14 14 14 10 14 14 10 14 14 14 14 14 35 14 14 14 14 14 14 14 36 15 37 14 14 14 14 14 14 14 14 14 14 36 15 37 14 14 14 14 14 14 14 14 14 14 14 14 14 14 14 14 14 14 14
14 14 14 14 14 14 14 14 10 14 14 35 14 14 14 14 14 10 14 14 35 10 14 14 14 36 15 37 14 14 10 14 14 14 14 14 14 14 36 15 37 14 14 14 14 14 14 14 14 14 14 14 14 14 14 14 14 14 14 14
14 14 14 14 14 14 14 14 10 14 14 10 14 14 14 14 14 10 14 10 10 14 14 14 14 36 15 37 14 14 14 14 14 10 14 14 14 14 36 15 37 14 14 14 14 14 14 14 14 14 14 14 14 14 14 14 14 14 14 14
14 14 14 14 14 14 14 14 10 14 14 10 10 10 35 10 10 35 14 10 14 14 14 14 14 36 15 37 14 14 14 14 14 10 14 14 14 14 36 15 37 14 14 14 14 14 14 14 14 14 14 14 14 14 14 14 14 14 14 14
14 14 14 14 14 14 14 14 10 14 14 35 10 10 10 10 10 10 10 10 14 14 14 14 14 36 15 37 14 14 14 14 14 14 14 14 14 14 41 39 42 14 14 14 14 14 14 14 14 14 14 14 14 14 14 14 14 14 14 14
14 14 14 14 14 14 14 14 10 14 14 10 10 10 10 10 10 10 10 14 14 14 14 14 14 36 15 37 14 14 14 14 14 14 14 14 14 14 10 35 10 14 14 14 14 14 14 14 14 14 14 14 14 14 14 14 14 14 14 14
14 14 14 14 14 14 14 14 10 14 14 10 10 10 35 10 10 35 10 10 14 14 14 14 14 36 15 37 14 14 14 14 14 14 14 14 14 14 10 10 10 14 14 14 14 14 14 14 14 14 14 14 14 14 14 14 14 14 14 14
14 14 14 14 14 14 14 14 10 14 14 10 35 10 10 10 10 10 14 35 10 14 14 14 14 36 15 37 14 14 14 14 14 14 14 14 14 14 10 10 35 14 14 14 14 14 14 14 14 14 14 14 14 14 14 14 14 14 14 14
14 14 14 14 14 14 14 14 10 14 14 10 10 10 35 10 10 10 14 14 10 14 14 14 14 36 15 37 14 14 14 14 14 14 14 14 14 14 35 10 10 14 14 14 14 14 14 14 14 14 14 14 14 14 14 14 14 14 14 14
14 14 14 14 14 14 14 14 10 14 14 14 14 14 14 14 14 14 14 14 10 14 14 14 14 36 15 37 14 14 14 14 14 14 14 14 14 14 10 10 35 14 14 14 14 14 14 10 10 10 14 14 14 14 14 14 14 14 14 14
14 14 14 14 14 14 14 14 10 14 14 14 14 14 14 14 14 14 14 14 35 10 10 35 10 41 39 42 10 10 14 14 14 14 14 14 14 10 10 35 10 10 35 10 10 10 10 35 45 10 46 14 14 14 14 14 14 14 14 14
14 14 14 14 14 14 14 14 10 14 14 14 14 14 14 14 14 14 14 14 10 10 10 10 10 10 10 10 10 35 10 14 14 10 14 14 35 10 10 10 10 35 14 14 14 10 10 10 10 35 10 14 14 14 14 14 14 14 14 14
14 14 14 14 14 14 14 14 10 14 14 14 14 14 14 14 14 14 14 14 10 10 35 10 10 10 10 10 10 10 10 14 14 14 14 10 10 10 10 10 10 10 14 14 14 14 14 10 10 10 10 14 14 14 14 14 14 14 14 14
14 14 14 14 14 14 14 14 10 14 14 14 14 14 14 14 10 14 14 14 14 10 10 10 35 10 10 10 10 10 10 10 14 14 14 10 10 10 10 35 14 10 14 14 14 14 14 14 10 10 10 14 14 14 14 14 14 14 14 14
14 14 14 14 14 14 14 14 10 14 14 14 14 14 14 14 14 14 14 14 14 10 35 10 10 10 10 35 10 10 10 35 10 10 10 35 10 14 10 10 10 10 14 14 14 14 14 14 10 35 10 14 14 14 14 14 14 14 14 14
14 14 14 14 14 14 14 14 10 14 14 14 14 14 14 14 10 14 14 14 14 14 10 10 10 10 35 10 10 10 14 14 14 14 10 10 10 10 10 10 10 10 14 14 14 14 14 14 14 35 10 14 14 14 14 14 14 14 14 14
14 14 14 14 14 14 14 14 10 14 14 14 10 10 10 10 10 14 14 14 14 14 14 10 10 10 10 10 10 14 14 14 14 14 10 10 14 10 35 14 10 35 14 14 14 14 14 14 14 10 10 14 14 14 14 14 14 14 14 14
14 14 14 14 14 14 14 14 10 14 14 10 10 10 14 10 10 10 14 14 14 14 14 14 14 14 10 14 14 14 14 14 14 14 14 35 10 10 35 10 10 14 14 14 14 14 14 14 14 10 10 14 14 14 14 14 14 14 14 14
14 14 14 14 14 14 14 14 10 14 14 10 35 10 10 10 10 10 14 14 14 14 14 14 14 14 10 14 14 14 14 14 14 14 14 14 14 14 35 14 14 14 14 14 14 14 14 14 10 10 10 35 14 14 14 14 14 14 14 14
14 14 14 14 14 14 14 14 10 10 10 10 10 10 10 35 10 10 14 14 14 14 14 14 14 14 10 14 14 14 14 14 14 14 14 14 14 14 10 14 14 14 14 14 14 14 14 10 10 10 10 10 14 14 14 14 14 14 14 14
14 14 14 14 14 14 14 14 15 14 14 10 10 10 10 10 10 10 14 14 14 14 14 14 14 14 35 14 14 14 14 14 14 14 14 14 14 14 10 14 14 14 14 14 14 14 14 10 35 10 10 10 14 14 14 14 14 14 14 14
14 14 14 14 14 14 14 14 15 14 14 10 10 10 10 10 10 10 10 10 10 10 10 14 14 14 35 10 14 14 14 14 14 14 14 14 14 14 35 35 35 10 14 14 14 14 10 10 10 14 10 10 14 14 14 14 14 14 14 14
14 14 14 14 14 14 14 14 15 14 14 14 10 10 35 10 10 14 10 10 10 10 10 10 14 14 14 10 35 14 14 14 14 14 14 14 14 14 14 14 10 35 14 14 14 10 10 14 14 14 14 14 14 14 14 14 14 14 14 14
14 14 14 14 14 14 14 14 15 14 14 14 14 14 10 10 10 10 10 10 10 10 10 10 14 14 14 14 10 10 14 14 14 14 14 14 14 14 14 35 10 14 14 14 10 10 14 14 14 14 14 14 14 14 14 14 14 14 14 14
14 14 14 14 14 14 14 14 15 14 14 14 14 14 14 10 10 14 14 14 10 35 10 10 35 14 14 14 14 10 35 14 14 14 14 35 10 35 10 10 10 10 10 10 10 14 14 14 14 14 14 14 14 14 14 14 14 14 14 14
14 14 14 14 14 14 14 14 15 14 14 14 14 14 14 14 14 14 14 14 10 10 10 10 10 10 14 14 14 14 10 14 14 14 14 10 14 14 14 14 14 14 25 11 11 11 11 11 11 11 11 26 14 14 14 14 14 14 14 14
14 14 14 14 14 14 14 14 15 15 15 14 14 14 14 14 14 14 14 14 10 10 10 10 10 35 14 14 14 10 10 35 14 14 14 35 14 14 14 14 14 14 18 32 32 32 32 32 32 32 32 19 14 14 14 14 14 14 14 14
14 14 14 14 14 14 14 14 14 14 15 14 14 14 14 14 14 14 14 14 10 45 10 10 10 10 14 14 14 10 14 10 43 38 44 10 14 14 14 14 14 14 18 32 32 32 32 32 32 32 32 19 14 14 14 14 14 14 14 14
14 14 14 14 14 14 14 14 14 14 15 14 14 14 14 14 14 14 14 14 10 10 10 35 10 14 14 14 10 35 14 14 36 15 37 14 14 14 14 14 14 14 18 16 16 16 16 16 16 16 16 19 14 14 14 14 14 14 14 14
14 14 14 14 14 14 14 14 14 14 15 14 14 14 14 14 14 14 14 10 10 10 10 10 10 14 14 14 10 10 14 14 36 15 37 14 25 11 11 11 11 11 28 16 16 17 16 16 16 16 16 19 14 14 14 14 14 14 14 14
14 14 14 14 14 14 14 14 34 34 35 34 34 14 14 14 14 14 10 10 10 14 14 10 14 14 14 14 35 10 14 14 36 15 37 14 18 32 32 32 32 32 21 16 16 16 16 16 16 16 16 19 14 14 14 14 14 14 14 14
14 14 14 14 14 14 14 14 34 13 13 13 34 14 14 14 14 14 10 14 14 14 14 10 14 10 14 14 10 14 14 14 36 15 37 14 18 32 33 32 32 32 21 16 16 16 16 16 16 17 16 19 14 14 14 14 14 14 14 14
14 14 14 14 14 14 14 14 34 13 13 13 34 14 14 14 14 14 10 14 14 14 14 35 10 10 14 14 10 10 14 14 36 15 37 14 18 16 16 16 16 16 27 22 22 22 29 16 30 22 22 31 14 14 14 14 14 14 14 14
14 14 14 14 14 14 14 14 34 13 13 13 34 14 14 14 14 14 10 10 14 14 14 10 10 14 14 14 10 10 14 14 36 15 40 38 18 16 16 16 16 16 16 16 16 16 16 16 16 16 16 19 14 14 14 14 14 14 14 14
14 14 14 14 14 14 14 14 34 13 13 13 34 14 14 14 14 14 14 10 35 14 14 10 14 14 14 14 35 10 14 14 36 15 15 15 16 16 16 16 16 16 17 16 16 16 16 16 16 16 16 19 14 14 14 14 14 14 14 14
14 14 14 14 14 14 14 14 34 34 34 34 34 14 14 14 14 14 14 14 10 10 10 35 14 14 14 14 10 10 14 14 41 39 39 39 18 16 16 16 16 16 16 16 16 16 16 16 17 16 16 19 14 14 14 14 14 14 14 14
14 14 14 14 14 14 14 14 14 14 14 14 14 14 14 14 14 14 14 14 10 10 35 14 14 14 14 14 10 10 14 10 14 35 14 14 18 16 16 16 16 16 16 16 16 16 16 16 16 16 16 19 14 14 14 14 14 14 14 14
14 14 14 14 14 14 14 14 14 14 14 14 14 14 14 14 14 14 14 14 14 14 14 14 14 14 14 10 10 14 14 10 10 10 14 14 23 20 20 20 20 20 20 20 20 20 20 20 20 20 20 24 14 14 14 14 14 14 14 14
14 14 14 14 14 14 14 14 14 14 14 14 14 14 14 14 14 14 14 14 14 14 14 14 14 14 10 10 35 14 14 10 10 14 14 14 14 14 14 14 14 14 14 14 14 14 14 14 14 14 14 14 14 14 14 14 14 14 14 14
14 14 14 14 14 14 14 14 14 14 14 14 14 14 14 14 14 14 14 14 14 14 14 35 10 10 10 10 14 14 14 35 14 14 14 14 14 14 14 14 14 14 14 14 14 14 14 14 14 14 14 14 14 14 14 14 14 14 14 14
14 14 14 14 14 14 14 14 14 14 14 14 14 14 14 14 14 14 14 14 14 14 14 14 10 10 10 14 14 14 10 10 14 14 14 14 14 14 14 14 14 14 14 14 14 14 14 14 14 14 14 14 14 14 14 14 14 14 14 14
14 14 14 14 14 14 14 14 14 14 14 14 14 14 14 14 14 14 14 14 14 14 14 14 10 35 10 14 14 10 10 10 14 14 14 14 14 14 14 14 14 14 14 14 14 14 14 14 14 14 14 14 14 14 14 14 14 14 14 14
14 14 14 14 14 14 14 14 14 14 14 14 14 14 14 14 14 14 14 14 14 14 14 14 10 10 10 14 10 35 10 14 14 14 14 14 14 14 14 14 14 14 14 14 14 14 14 14 14 14 14 14 14 14 14 14 14 14 14 14
14 14 14 14 14 14 14 14 14 14 14 14 14 14 14 14 14 14 14 14 14 14 14 14 10 10 10 10 10 10 14 14 14 14 14 14 14 14 14 14 14 14 14 14 14 14 14 14 14 14 14 14 14 14 14 14 14 14 14 14
14 14 14 14 14 14 14 14 14 14 14 14 14 14 14 14 14 14 14 14 14 14 14 14 10 35 10 10 10 14 14 14 14 14 14 14 14 14 14 14 14 14 14 14 14 14 14 14 14 14 14 14 14 14 14 14 14 14 14 14
14 14 14 14 14 14 14 14 14 14 14 14 14 14 14 14 14 14 14 14 14 14 14 14 10 10 10 10 10 14 14 14 14 14 14 14 14 14 14 14 14 14 14 14 14 14 14 14 14 14 14 14 14 14 14 14 14 14 14 14
14 14 14 14 14 14 14 14 14 14 14 14 14 14 14 14 14 14 14 14 14 14 14 14 14 10 10 10 14 14 14 14 14 14 14 14 14 14 14 14 14 14 14 14 14 14 14 14 14 14 14 14 14 14 14 14 14 14 14 14
14 14 14 14 14 14 14 14 14 14 14 14 14 14 14 14 14 14 14 14 14 14 14 14 14 10 10 10 14 14 14 14 14 14 14 14 14 14 14 14 14 14 14 14 14 14 14 14 14 14 14 14 14 14 14 14 14 14 14 14
14 14 14 14 14 14 14 14 14 14 14 14 14 14 14 14 14 14 14 14 14 14 14 14 14 10 10 10 14 14 14 14 14 14 14 14 14 14 14 14 14 14 14 14 14 14 14 14 14 14 14 14 14 14 14 14 14 14 14 14
14 14 14 14 14 14 14 14 14 14 14 14 14 14 14 14 14 14 14 14 14 14 14 14 14 14 14 14 14 14 14 14 14 14 14 14 14 14 14 14 14 14 14 14 14 14 14 14 14 14 14 14 14 14 14 14 14 14 14 14
14 14 14 14 14 14 14 14 14 14 14 14 14 14 14 14 14 14 14 14 14 14 14 14 14 14 14 14 14 14 14 14 14 14 14 14 14 14 14 14 14 14 14 14 14 14 14 14 14 14 14 14 14 14 14 14 14 14 14 14
14 14 14 14 14 14 14 14 14 14 14 14 14 14 14 14 14 14 14 14 14 14 14 14 14 14 14 14 14 14 14 14 14 14 14 14 14 14 14 14 14 14 14 14 14 14 14 14 14 14 14 14 14 14 14 14 14 14 14 14
14 14 14 14 14 14 14 14 14 14 14 14 14 14 14 14 14 14 14 14 14 14 14 14 14 14 14 14 14 14 14 14 14 14 14 14 14 14 14 14 14 14 14 14 14 14 14 14 14 14 14 14 14 14 14 14 14 14 14 14
14 14 14 14 14 14 14 14 14 14 14 14 14 14 14 14 14 14 14 14 14 14 14 14 14 14 14 14 14 14 14 14 14 14 14 14 14 14 14 14 14 14 14 14 14 14 14 14 14 14 14 14 14 14 14 14 14 14 14 14
14 14 14 14 14 14 14 14 14 14 14 14 14 14 14 14 14 14 14 14 14 14 14 14 14 14 14 14 14 14 14 14 14 14 14 14 14 14 14 14 14 14 14 14 14 14 14 14 14 14 14 14 14 14 14 14 14 14 14 14
14 14 14 14 14 14 14 14 14 14 14 14 14 14 14 14 14 14 14 14 14 14 14 14 14 14 14 14 14 14 14 14 14 14 14 14 14 14 14 14 14 14 14 14 14 14 14 14 14 14 14 14 14 14 14 14 14 14 14 14


